Spanish; Castilian = spa
French = fra
German = ger
Romanian; Moldavian; Moldovan = rum
Arabic = ara
Chinese (Simplified) = chi
Russian = rus
Japanese = jpn
Chinese (Traditional) = cht
Danish = dan
Dutch; Flemish = dut
Hindi = hin
Korean = kor
Persian = per
Polish = pol
Czech = cze
Swedish = swe
Portuguese = por
Italian = ita
Hausa = hau
Greek = gre
Norwegian = nor
Urdu = urd
Hungarian = hun
Thai = tha
Hebrew = heb
Turkish = tur
Bulgarian = bul
Serbian = srp
Finnish = fin
Pushto; Pashto = pus
Indonesian = ind
English = eng
Bengali = ben
Estonian = est
Dari = fad
Lithuanian = lit
Slovak = slo
Slovenian = slv
Somali = som
Ukrainian = ukr
Malay = may
Vietnamese = vie
